Test Level
################################################################################################################
#......#...@........................................................................#..........................#
#......#............................................................................#..........................#
#......############....................................................##############..........................#
#...................................................................................#..........#...............#
#.......................................#################............................#.........................#
#....................##########...............#................................................................#
#.............................................#..........................##...........................#........#
#.............................................#.....................................#......#...................#
#.............................................########.............####.............#..........................#
#..................................####........................................................................#
###############...............................................................................#.............#..#
#...................................................................................#..........................#
#...................................................................................#..........................#
#...................................................................................#..........................#
#...................................................................................#..........................#
################################################################################################################