["                                                          ",
"                                                           ",
"                                                           ",
"       2                 #################                 ",
"                         #             sss                 ",
"      ########     #######                                 ",
"   ####ssssss#     #sssss                                  ",
"####s        #######                       #####           ",
"#sss         ssssss                                        ",
"# @                     ##                    f            ",
"#      SSS            SS#                        ####      ",
"############################                               ",
"         ssssssss       sss#lllllllllllllllll#             ",
" 1                   j     ###################             ",
"                                           sss             ",
"                                   j                       ",
"                                                           ",
"                                                           ",
"                                                           ",
"                                                           ",
"  XXXXX                                                    ",
"  X   X                                                    ",
"  X * X                                                    ",
"  X   X                                                    ",
"  XXXXX                                                    ",
"                                                           ",
"                                                           ",]